Voiceless alveolar sibilant affricate=t͡s
Voiced alveolar sibilant affricate=d͡z
Voiceless palato-alveolar sibilant affricate=t͡ʃ
Voiced palato-alveolar sibilant affricate=d͡ʒ
Voiceless retroflex sibilant affricate=ʈ͡ʂ
Voiced retroflex sibilant affricate=ɖ͡ʐ
Voiceless alveolo-palatal sibilant affricate=t͡ɕ
Voiced alveolo-palatal sibilant affricate=d͡ʑ
Voiceless bilabial post-trilled dental stop=t̪͡ʙ̥
Voiceless bilabial affricate=p͡ɸ
Voiced bilabial affricate=b͡β
Voiceless labiodental affricate=p̪͡f
Voiced labiodental affricate=b̪͡v
Voiceless dental non-sibilant affricate=t͡θ
Voiced dental non-sibilant affricate=d͡ð
Voiceless alveolar non-sibilant affricate=t͡ɹ̝̊
Voiced alveolar non-sibilant affricate=d͡ɹ̝
Retroflex trill=ɽ͡r
Voiceless palatal affricate=c͡ç
Voiced palatal affricate=ɟ͡ʝ
Voiceless velar affricate=k͡x
Voiced velar affricate=ɡ͡ɣ
Voiceless uvular affricate=q͡χ
Voiced epiglottal affricate=ʡ͡ʢ
Voiceless glottal affricate=ʔ͡h
Voiceless uvular fricative trill=x͡ʀ̥
Voiceless epiglottal affricate=ʡ͡ʜ
Voiceless alveolar lateral affricate=t͡ɬ
Voiced alveolar lateral affricate=d͡ɮ
Voiceless retroflex lateral affricate=ʈ͜ɭ̊˔
Voiceless palatal lateral affricate=c͡ʎ̥˔
Voiceless velar lateral affricate=k͡ʟ̝̊
Voiced velar lateral affricate=ɡ͡ʟ̝
Dental ejective affricate=t͡θʼ
Alveolar ejective affricate=t͡sʼ
Palato-alveolar ejective affricate=t͡ʃʼ
Retroflex ejective affricate=ʈ͡ʂʼ
Alveolo-palatal ejective affricate=t͡ɕʼ
Palatal ejective affricate=c͡çʼ
Velar ejective affricate=k͡xʼ
Uvular ejective affricate=q͡χʼ
Palatal lateral ejective affricate=c͡ʎ̝̊ʼ
Velar lateral ejective affricate=k͡ʟ̝̊ʼ
