Voiceless bilabial nasal=m̥
Bilabial nasal=m
Labiodental nasal=ɱ
Linguolabial nasal=n̼
Voiceless alveolar nasal=n̥
Alveolar nasal=n
Voiceless retroflex nasal=ɳ̊
Retroflex nasal=ɳ
Voiceless palatal nasal=ɲ̊
Palatal nasal=ɲ
Voiceless velar nasal=ŋ̊
Velar nasal=ŋ
Uvular nasal=ɴ
Voiceless bilabial stop=p
Voiced bilabial stop=b
Voiceless labiodental stop=p̪
Voiced labiodental stop=b̪
Voiceless linguolabial stop=t̼
Voiced linguolabial stop=d̼
Voiceless dental stop=t̪
Voiced dental stop=d̪
Voiceless alveolar stop=t
Voiced alveolar stop=d
Voiceless retroflex stop=ʈ
Voiced retroflex stop=ɖ
Voiceless palatal stop=c
Voiced palatal stop=ɟ
Voiceless velar stop=k
Voiced velar stop=ɡ
Voiceless uvular stop=q
Voiced uvular stop=ɢ
Epiglottal stop/Pharyngeal stop=ʡ
Glottal stop=ʔ
Voiceless alveolar sibilant=s
Voiceless laminal dentalized alveolar sibilant=s̪
Voiceless alveolar retracted sibilant=s̠
Voiceless denti-alveolar sibilant=s̻̪
Voiced laminal dentalized alveolar sibilant=z̪
Voiced alveolar sibilant=z
Voiceless palato-alveolar fricative=ʃ
Voiced palato-alveolar fricative=ʒ
Voiceless retroflex fricative=ʂ
Voiced retroflex fricative=ʐ
Voiceless alveolo-palatal fricative=ɕ
Voiced alveolo-palatal fricative=ʑ
Voiceless bilabial fricative=ɸ
Voiced bilabial fricative=β
Voiceless labiodental fricative=f
Voiced labiodental fricative=v
Voiceless linguolabial fricative=θ̼
Voiced linguolabial fricative=ð̼
Voiceless dental fricative=θ
Voiced dental fricative=ð
Voiceless alveolar non-sibilant fricative=θ̱
Voiced alveolar non-sibilant fricative=ð̠
Voiceless postalveolar non-sibilant fricative=ɹ̠̊˔
Voiced postalveolar non-sibilant fricative=ɹ̠˔
Voiced retroflex non-sibilant fricative=ɻ̝
Voiceless palatal fricative=ç
Voiced palatal fricative=ʝ
Voiceless velar fricative=x
Voiced velar fricative=ɣ
Voiceless uvular fricative=χ
Voiced uvular fricative=ʁ
Voiceless pharyngeal fricative=ħ
Voiced pharyngeal fricative=ʕ
Voiceless glottal fricative=h
Voiced glottal fricative=ɦ
Voiceless labiodental approximant=ʋ̥
Labiodental approximant=ʋ
Voiceless alveolar approximant=ɹ̥
Alveolar approximant=ɹ
Voiceless retroflex approximant=ɻ̊
Retroflex approximant=ɻ
Voiceless palatal approximant=j̊
Palatal approximant=j
Voiceless velar approximant=ɰ̊
Velar approximant=ɰ
Creaky-voiced glottal approximant=ʔ̰
Bilabial flap=ⱱ̟
Labiodental flap=ⱱ
Voiceless alveolar tap=ɾ̥
Voiced alveolar flap=ɾ
Voiceless retroflex flap=ɽ̊
Retroflex flap=ɽ
Uvular flap=ɢ̆
Epiglottal flap=ʡ̆
Voiceless bilabial trill=ʙ̥
Bilabial trill=ʙ
Voiceless alveolar trill=r̥
Voiced alveolar trill=r
Raised alveolar trill=r̝
Voiceless retroflex trill=ɽ͡r̥
Retroflex trill=ɽ͡r
Voiceless uvular trill=ʀ̥
Uvular trill=ʀ
Voiceless pharyngeal trill/Voiceless epiglottal fricative=ʜ
Voiced pharyngeal trill/Voiced epiglottal fricative=ʢ
Voiceless alveolar lateral fricative=ɬ
Voiced alveolar lateral fricative=ɮ
Voiceless retroflex lateral fricative=ꞎ
Voiced retroflex lateral fricative=ɭ˔
Voiceless palatal lateral fricative=ʎ̝̊
Voiced palatal lateral fricative=ʎ̝
Voiceless velar lateral fricative=ʟ̝̊
Voiced velar lateral fricative=ʟ̝
Voiceless alveolar lateral approximant=l̥
Alveolar lateral approximant=l
Voiceless retroflex lateral approximant=ɭ̊
Retroflex lateral approximant=ɭ
Voiceless palatal lateral approximant=ʎ̥
Palatal lateral approximant=ʎ
Voiceless velar lateral approximant=ʟ̥
Voiced velar lateral approximant=ʟ
Uvular lateral approximant=ʟ̠
Alveolar lateral flap=ɺ
Retroflex lateral flap=ɭ̆
Palatal lateral flap=ʎ̆
Velar lateral tap=ʟ̆
Swedish Sj Sound/Voiceless postalveolo-velar fricative=ɧ
Voiceless labialized velar approximant=ʍ
Voiced labio-velar approximant=w
Compressed labio-velar approximant=ɰᵝ
Velarized L/Dark L/Velarized alveolar lateral approximant=ɫ
Voiceless labialized palatal approximant=ɥ̊
Labialized palatal approximant=ɥ
Tenuis bilabial click=ʘ
Voiced bilabial click=ʘ̬
Tenuis dental click=ǀ
Voiced dental click=ǀ̬
Tenuis alveolar click=ǃ
Voiced alveolar click=ǃ̬
Tenuis retroflex click=ǃ˞
Voiced retroflex click=ǃ̬˞
Tenuis palatal click=ǂ
Voiced palatal click=ǂ̬
Bilabial nasal click=ʘ̃
Dental nasal click=ǀ̃
Alveolar nasal click=ǃ̃
Palatal nasal click=ǂ̃
Tenuis lateral click=ǁ
Voiced lateral click=ǁ̬
Lateral nasal click=ǁ̃
Voiceless bilabial implosive=ɓ̥
Voiced bilabial implosive=ɓ
Voiceless alveolar implosive=ɗ̥
Voiced alveolar implosive=ɗ
Voiceless retroflex  implosive=ᶑ̥
Voiced retroflex implosive=ᶑ
Voiceless palatal implosive=ʄ̊
Voiced palatal implosive=ʄ
Voiceless velar implosive=ɠ̊
Voiced velar implosive=ɠ
Voiceless uvular implosive=ʛ̥
Voiced uvular implosive=ʛ
Bilabial ejective=pʼ
Dental ejective=t̪ʼ
Alveolar ejective=tʼ
Retroflex ejective=ʈʼ
Palatal ejective=cʼ
Velar ejective=kʼ
Uvular ejective=qʼ
Epiglottal ejective=ʡʼ
Bilabial ejective fricative=ɸʼ
Labiodental ejective fricative=fʼ
Dental ejective fricative=θʼ
Alveolar ejective fricative=sʼ
Alveolar lateral ejective fricative=ɬ’
Palato-alveolar ejective fricative=ʃʼ
Retroflex ejective fricative=ʂʼ
Alveolo-palatal ejective fricative=ɕʼ
Palatal ejective fricative=çʼ
Velar ejective fricative=x’
Uvular ejective fricative=χ’
Voiceless labial–alveolar stop=t͡p
Voiced labial–alveolar stop=d͡b
Voiceless labial–velar stop=k͡p
Voiced labial–velar stop=ɡ͡b
Uvular–epiglottal stop=q͡ʡ
Labial–alveolar nasal=n͡m
Labial–velar nasal=ŋ͡m